 Ah, it's so warm and cozy at home.  And today is Christmas Eve!  There will probably be tons of presents under the tree, and the food! The best food ever, roast beef, garlic mashed potatoes and gravy, how delicious.  Hey, what's up with this room?  This isn't my house, I don't have a fireplace, a lamp on the wall, or wooly carpet like this!  Ah, and why am I carrying a keyring and a letter?

ReplacementClause
An Interactive Fiction by Makana Tavepholjalern
Release 1 / Serial number 130317 / Inform 7 build 6G60 (I6/v6.32 lib 6/12N) SD

Home Room
 A beautifully old fashioned room with red brick walls.  The carpet is made of unbleached wool, and is soft and comforting to the touch.  There is a fireplace in the north facing wall.  The fire within the hearth is buringing merrily, and you can feel its gentle warmth.  Above it, there is a lamp hanging on the wall. Looking around, there is a gate to the west, a hardwood door to the south, a white door to the east, and an open door to the north through which you can smell roasting root vegitables.

You can see a White Door, a Hardwood Door, a Gate, a lamp and a Fireplace (in which is a Fire) here.

>light lamp
This dangerous act would achieve little.

>turn on lamp
 You light the lamp in the fire, and you're happy that it's buring bright.

* * *

>x dark shape
You can't see any such thing.

>n
Kitchen
 The heat of the hearth in the home room is felt even here in the kitchen.  The walls are made of red brick, and there is a dinging table laden with food.  The east wall has some characters carved into the wall.  To the north is the front door of the house.

You can see a front door and Dining table (on which are Beef Roast., Mashedpotatoes, Roasted turkey, Smoked ham, Green beans and Bread Pudding) here.

>go near the elf
You can't see any such thing.

* * *

>x window
You can't see any such thing.

* * *

>x me
You see nothing special about yourself.

* * *

>take lamp
Taken.

>turn on lamp
 You light the lamp in the fire, and you're happy that it's buring bright.

>e
(first opening the White Door)
It seems to be locked.

>n
Kitchen
 The heat of the hearth in the home room is felt even in the kitchen.  The walls are made of red brick, and there is a dinging table laden with food.  The east wall has some characters carved into the wall that you are unable to understand. 

You can see a front door and Dining table (on which are Beef roast, Mashed potatoes, Roast Turkey, Smoked ham, Green beans and Bread Pudding) here.

>s
Home Room
 A beautifully old fashioned room with red brick walls.  The carpet is made of unbleached wool, and is soft and comforting to the touch.  There is a fireplace in the north facing wall.  The fire within the hearth is buringing merrily, and you can feel its gentle warmth.  Above it, there is a lamp hanging on the wall. Looking around, there is a gate to the west, a hardwood door to the south, a white door to the east, and an open door to the north through which you can smell roasting root vegitables.

You can see a White Door, a Hardwood Door, a Gate and a Fireplace (in which is a Fire) here.

>unlock white door with silver key
(first taking the Silver key)
That doesn't seem to fit the lock.

>i
You are carrying:
  a Silver key
  a lamp
  Envelope (closed)
  Key Ring
    brass key
    a Metal key

>unlock white door with metal key
(first taking the Metal key)
You unlock the White Door.

>open white door
You open the White Door.

>e
Darkness
It is pitch dark, and you can't see a thing.

>light lamp
This dangerous act would achieve little.

* * *

>e
(first opening the White Door)
It seems to be locked.

>take hammer
You can't see any such thing.

>open white door with metal key
(first taking the Metal key)
You unlock the White Door.

>e
(first opening the White Door)

toy room
 A long room with a worktable stretching all the way down the middle.  This must be where all of the toys are made.  There is also a workbench, which is probably where the elves sit while they are doing their work.  On the eastern wall is a window looking out into the night. Way down in the corner is a big red bag, and sitting on the table right infront of you is a mini hammer.

On the Worktable is Mini Hammer.

You can also see a White Door and Toybag (empty) here.

>take hammer
Taken.

>hit key with hammer
Which do you mean, the Metal key, Key Ring, the Silver key or brass key?

>hit brass key with hammer
You hammer the key back into shape! Now it works. Yay.

>w
Home Room
 A beautifully old fashioned room with red brick walls.  The carpet is made of unbleached wool, and is soft and comforting to the touch.  There is a fireplace in the north facing wall.  The fire within the hearth is buringing merrily, and you can feel its gentle warmth.  Above it, there is a lamp hanging on the wall. Looking around, there is a gate to the west, a hardwood door to the south, a white door to the east, and an open door to the north through which you can smell roasting root vegitables.

You can see a White Door, a Hardwood Door, a Gate and a Fireplace (in which is a Fire) here.

>unlock hardwood door with brass key
You unlock the Hardwood Door.

>s
(first opening the Hardwood Door)

Santa's office
 So this is Santa's office.  As you walk into the room, you take notice of a strange machine bolted to the western wall.  This must be the Santa Transformer.  There is also a brown leather coat hanging on the wall and a window.

You can see a Hardwood Door and Coat here.

>take coat
Taken.

>n
Home Room
 A beautifully old fashioned room with red brick walls.  The carpet is made of unbleached wool, and is soft and comforting to the touch.  There is a fireplace in the north facing wall.  The fire within the hearth is buringing merrily, and you can feel its gentle warmth.  Above it, there is a lamp hanging on the wall. Looking around, there is a gate to the west, a hardwood door to the south, a white door to the east, and an open door to the north through which you can smell roasting root vegitables.

You can see a Hardwood Door, a Gate, a White Door and a Fireplace (in which is a Fire) here.

>wear coat
You put on Coat.

>n
Kitchen
 The heat of the hearth in the home room is felt even here in the kitchen.  The walls are made of red brick, and there is a dinging table laden with food.  The east wall has some characters carved into the wall.  To the north is the front door of the house.

You can see a front door and Dining table (on which are Beef Roast., Mashedpotatoes, Roasted turkey, Smoked ham, Green beans and Bread Pudding) here.

>n
(first opening the front door)
 You are greeted by a cold blast of artic air, but you're mostly warm becasue of the coat you're wearing.  Your fingertips are freezing cold, so you shove them deep into your pockets; ah much better.  Ahead of you is the cold wasteland of the artic.  There is a blizzard going on outside, but through the thick drift of snow you can see a dark shape in the distance.

>i
You are carrying:
  Coat (being worn)
  a brass key
  Mini Hammer
  a Metal key
  a lamp (providing light)
  Envelope (closed)
  Key Ring
    a Silver key

* * *

>turn on lamp
 You light the lamp in the fire, and you're happy that it's buring bright.

>unlock white door with metal key
(first taking the Metal key)
You unlock the White Door.

>e
(first opening the White Door)

toy room
 A long room with a worktable stretching all the way down the middle.  This must be where all of the toys are made.  There is also a workbench, which is probably where the elves sit while they are doing their work.  On the eastern wall is a window looking out into the night. Way down in the corner is a big red bag, and sitting on the table right infront of you is a mini hammer.

On the Worktable is Mini Hammer.

You can also see a White Door and Toybag (empty) here.

* * *

>take hammer
Taken.

>hit brass key with hammer
You hammer the key back into shape! Now it works. Yay.

>x toybag
 A gigantic bag is as round as a tomato, and goes all the way up to your chest.  It is bright crimpson, and the top is tied with golden string.

>take bag
 You pull, and tug, but you can't move the bag an inch.  What's in this thing, stones?.

>take toybag
 You pull, and tug, but you can't move the bag an inch.  What's in this thing, stones?.

>w
Home Room
 A beautifully old fashioned room with red brick walls.  The carpet is made of unbleached wool, and is soft and comforting to the touch.  There is a fireplace in the north facing wall.  The fire within the hearth is buringing merrily, and you can feel its gentle warmth.  Above it, there is a lamp hanging on the wall. Looking around, there is a gate to the west, a hardwood door to the south, a white door to the east, and an open door to the north through which you can smell roasting root vegitables.

You can see a White Door, a Hardwood Door, a Gate and a Fireplace (in which is a Fire) here.

>n
Kitchen
 The heat of the hearth in the home room is felt even here in the kitchen.  The walls are made of red brick, and there is a dining table laden with food.  The east wall has some characters carved into the wall.  To the north is the front door of the house.

You can see a front door and Dining table (on which are Mashed Potatoes, Beef Roast, Green Beans, Smoked Ham, Bread Pudding and Roasted Turkey) here.

>x table
 A circular oak dining table with four legs, supporting a christmast feast.  On the table there are mashed potatoes, roasted turkey, smoked ham, green beans, bread pudding, and beef roast.

On Dining table are Mashed Potatoes, Beef Roast, Green Beans, Smoked Ham, Bread Pudding and Roasted Turkey.

>Take beef roast
Taken.

>x mashed potatoes
You see nothing special about Mashed Potatoes.

>eat mashed potatoes
(first taking Mashed Potatoes)
You eat Mashed Potatoes. Not bad.

>x roasted turkey
 This 12 lb bird has been roasted to golden brown perfection; makes me want to sample.

>eat turkey
(first taking Roasted Turkey)
 The light and dark meat is juicy and delicious.  The crispy skin is slightly salted, and you can smell the aroma of rosemary and thyme.  You eat the entire turkey, you really have the appetite of a true santa.

>x smoked ham
 Smoked ham with some kind of glaze on it.  The ham must be at least 10 lbs, who could eat all this food?.

>eat smoked ham
(first taking Smoked Ham)
 Mmm, smoked elven ham, glazed with mustard and honey.  The sugars have carmelized on the outside of the meat, and the bone keeps in all the juices.  How can you eat so much?

>x green beans
 Green bean caserole fresh from the oven.  It looks dangerously delicious with all those fried onions on top.

>eat beans
(first taking Green Beans)
 Crispy green bean caserole.  Here's your serving of vegetables for the day.  Even though they're green, they're delicious.  The perfect compliment to every holiday meal.

>x pudding
 Christmas bread pudding; mmm, it smells like cinnamon.

>eat pudding
(first taking Bread Pudding)
 Sweet, soft, and still warm.  There are chunks of chewy candied fruits just like how mom makes every year.  The undertones of cinnamon and allspice permiate the room as you polish off every last bite.

>x roast
 A huge hunk of meat, seared and roasted to perfection.  The Beef Roast is crusted with salt, pepper, garlic, and oregano.  There's so much food, maybe you should save this dish for later.

>x beef roast
 A huge hunk of meat, seared and roasted to perfection.  The Beef Roast is crusted with salt, pepper, garlic, and oregano.  There's so much food, maybe you should save this dish for later.

>x table
 A circular oak dining table with four legs, supporting a christmast feast.  On the table there are mashed potatoes, roasted turkey, smoked ham, green beans, bread pudding, and beef roast.

>x Beef Roast
 A huge hunk of meat, seared and roasted to perfection.  The Beef Roast is crusted with salt, pepper, garlic, and oregano.  There's so much food, maybe you should save this dish for later.

>Take beef roast
You already have that.

>eat beef roast
 Remember what santa said in his letter? You'll need some food later on.  Why don't you dig into some of the other stuff.

>x fuel
You can't see any such thing.

>x roast
 A huge hunk of meat, seared and roasted to perfection.  The Beef Roast is crusted with salt, pepper, garlic, and oregano.  There's so much food, maybe you should save this dish for later.

>take roast
You already have that.

>eat roast
 Remember what santa said in his letter? You'll need some food later on.  Why don't you dig into some of the other stuff.

>eat mashed potatoes
You can't see any such thing.

>l
Kitchen
 The heat of the hearth in the home room is felt even here in the kitchen.  The walls are made of red brick, and there is a dining table laden with food.  The east wall has some characters carved into the wall.  To the north is the front door of the house.

You can see a front door and Dining table here.

>s
Home Room
 A beautifully old fashioned room with red brick walls.  The carpet is made of unbleached wool, and is soft and comforting to the touch.  There is a fireplace in the north facing wall.  The fire within the hearth is buringing merrily, and you can feel its gentle warmth.  Above it, there is a lamp hanging on the wall. Looking around, there is a gate to the west, a hardwood door to the south, a white door to the east, and an open door to the north through which you can smell roasting root vegitables.

You can see a White Door, a Hardwood Door, a Gate and a Fireplace (in which is a Fire) here.

>unlock gate with silver key
(first taking the Silver key)
You unlock the Gate.

>open gate
 You are greeted by a cold blast of artic air that chills you to the core.  You're definately going to need some protection against the elements.  After all, you're only wearing a t-shirt and shorts..

>w
You need to put on the coat before going to such a cold place.

>e
toy room
 A long room with a worktable stretching all the way down the middle.  This must be where all of the toys are made.  There is also a workbench, which is probably where the elves sit while they are doing their work.  On the eastern wall is a window looking out into the night. Way down in the corner is a big red bag, and sitting on the table right infront of you is a mini hammer.

You can see a White Door and Toybag (empty) here.

>take toybag
 You pull, and tug, but you can't move the bag an inch.  What's in this thing, stones?.

* * *

>e
(first opening the White Door)

toy room
 A long room with a worktable stretching all the way down the middle.  This must be where all of the toys are made.  There is also a workbench, which is probably where the elves sit while they are doing their work.  On the eastern wall is a window looking out into the night. Way down in the corner is a big red bag, and sitting on the table right infront of you is a mini hammer.

On the Worktable is Mini Hammer.

You can also see a White Door and Toybag (empty) here.

>hit key with hammer
Which do you mean, the Metal key, Key Ring, the Silver key or brass key?

>take key
Which do you mean, the Metal key, Key Ring, the Silver key or brass key?

>take hammer
Taken.

>hit brass key with mini hammer
You hammer the key back into shape! Now it works. Yay.

>w
Home Room
 A beautifully old fashioned room with red brick walls.  The carpet is made of unbleached wool, and is soft and comforting to the touch.  There is a fireplace in the north facing wall.  The fire within the hearth is buringing merrily, and you can feel its gentle warmth.  Above it, there is a lamp hanging on the wall. Looking around, there is a gate to the west, a hardwood door to the south, a white door to the east, and an open door to the north through which you can smell roasting root vegitables.

You can see a White Door, a Hardwood Door, a Gate and a Fireplace (in which is a Fire) here.

* * *

>unlock hardwood door with brass key
You unlock the Hardwood Door.

>s
 Are you going to walk through a hardwood door?  Who do you think you are?  You'll need to fix your keys.

>open hardwood door
You open the Hardwood Door.

>s
 Are you going to walk through a hardwood door?  Who do you think you are?  You'll need to fix your keys.

>s
 Are you going to walk through a hardwood door?  Who do you think you are?  You'll need to fix your keys.

>unlock hardwood door with brass key
That's unlocked at the moment.

>open hardwood door
That's already open.

>s
 Are you going to walk through a hardwood door?  Who do you think you are?  You'll need to fix your keys.

* * *

>take lamp
Taken.

>light lamp
This dangerous act would achieve little.

* * *

>unlock white door with metal key
(first taking the Metal key)
You unlock the White Door.

>e
(first opening the White Door)

Darkness
It is pitch dark, and you can't see a thing.

>i
You are carrying:
  a Metal key
  a lamp
  Envelope (closed)
  Key Ring
    a Silver key
    brass key

* * *

>open white door
You open the White Door.

>e
Toy Room
 A long room with a worktable stretching all the way down the middle.  This must be where all of the toys are made.  There is also a workbench, which is probably where the elves sit while they are doing their work.  Way down in the corner is a big red bag, and sitting on the table right infront of you is a mini hammer.

On the Worktable is Mini Hammer.

You can also see a White Door and Toybag (empty) here.

* * *

>n
Kitchen
 The heat of the hearth in the home room is felt even here in the kitchen.  The walls are made of red brick, and there is a dinging table laden with food.  The east wall has some characters carved into the wall. 

You can see a front door and Dining table (on which are Beef Roast., Mashedpotatoes, Roasted turkey, Smoked ham, Green beans and Bread Pudding) here.

>x food
You can't see any such thing.

>x ham
You see nothing special about Smoked ham.

* * *

>n
Kitchen
 The heat of the hearth in the home room is felt even here in the kitchen.  The walls are made of red brick, and there is a dinging table laden with food.  The east wall has some characters carved into the wall. 

You can see a front door and Dining table (on which are Beef Roast., Mashedpotatoes, Roasted turkey, Smoked ham, Green beans and Bread Pudding) here.

>x wall
 You examine the curvy lines of the characters, but see nothing that you understand.  Upon closer inspection, you see that there is a line that marks out a rectangle that goes from the floor until your waist.

>push wall
You must supply a noun.

>open wall
You must supply a noun.

* * *

>x wall
 You examine the curvy lines of the characters, but see nothing that you understand.  Upon closer inspection, you see that there is a line that marks out a rectangle that goes from the floor until your waist.

>x stone door
You see nothing special about the stone door.

* * *

>n
Kitchen
 The heat of the hearth in the home room is felt even here in the kitchen.  The walls are made of red brick, and there is a dinging table laden with food.  The east wall has some characters carved into the wall. 

You can see a front door and Dining table (on which are Beef Roast., Mashedpotatoes, Roasted turkey, Smoked ham, Green beans and Bread Pudding) here.

>n
You need to put on the coat before going to such a cold place.

* * *

>n
Kitchen
 The heat of the hearth in the home room is felt even here in the kitchen.  The walls are made of red brick, and there is a dinging table laden with food.  The east wall has some characters carved into the wall. 

You can see a front door and Dining table (on which are Beef Roast., Mashedpotatoes, Roasted turkey, Smoked ham, Green beans and Bread Pudding) here.

>x beef roast
You can't see any such thing.

>x dining table
 A circular oak dining table with four legs, supporting a christmast feast.

On Dining table are Beef Roast., Mashedpotatoes, Roast Turkey, Smoked ham, Green beans and Bread Pudding.

>x beef roast
You can't see any such thing.

>x mashed potatoes
You see nothing special about Mashedpotatoes.

* * *

>x beef roast
You can't see any such thing.

>x table
 A circular oak dining table with four legs, supporting a christmast feast.

On Dining table are Beef Roast., Mashedpotatoes, Roast Turkey, Smoked ham, Green beans and Bread Pudding.

>x beef roast
You can't see any such thing.

>eat beef roast
You can't see any such thing.

>eat mashed potatoes
(first taking Mashedpotatoes)
 Creamy, buttery, and salty with the aftertaste of roasted garlic.  Just what holiday mashed potatoes should taste like.

>eat roast turkey
(first taking Roast Turkey)
 The light and dark meat is juicy and delicious.  The crispy skin is slightly salted, and you can smell the aroma of rosemary and thyme.  You eat the entire turkey, you really have the appetite of a true santa.

>eat smoked ham
(first taking Smoked ham)
 Mmm, smoked elven ham, glazed with mustard and honey.  The sugars have carmelized on the outside of the meat, and the bone keeps in all the juices.  How can you eat so much?

>eat green beans
(first taking Green beans)
 Crispy green bean caserole.  Here's your serving of vegetables for the day.  Even though they're green, they're delicious.  The perfect compliment to every holiday meal.

>eat bread pudding
(first taking Bread Pudding)
 Sweet, soft, and still warm.  There are chunks of chewy candied fruits just like mom makes every year.  The understones of cinnamon and allspice permiate the room as you polish off every last bite.

* * *

>n
Kitchen
 The heat of the hearth in the home room is felt even here in the kitchen.  The walls are made of red brick, and there is a dinging table laden with food.  The east wall has some characters carved into the wall. 

You can see a front door and Dining table (on which are Beef Roast., Mashedpotatoes, Roasted turkey, Smoked ham, Green beans and Bread Pudding) here.

>x fuel
 .

>x roast beef
I only understood you as far as wanting to examine Roast Turkey.

>x beef roast
You can't see any such thing.

* * *

>s
 Are you going to walk through a hardwood door?  Who do you think you are?  You'll need to hammer that brass key flat again before you can unlock .