 Ah, it's so warm and cozy at home.  And today is Christmas Eve!  There will probably be tons of presents under the tree, and the food! The best food ever, roast beef, garlic mashed potatoes and gravy, how delicious.  Hey, what's up with this room?  This isn't my house, I don't have a fireplace, a lamp on the wall, or wooly carpet like this!  Ah, and why am I carrying a keyring and a letter?

ReplacementClause
An Interactive Fiction by Makana Tavepholjalern
Release 1 / Serial number 130313 / Inform 7 build 6G60 (I6/v6.32 lib 6/12N) SD

Home Room
 A beautifully old fashioned room with red brick walls.  The carpet is made of unbleached wool, and is soft and comforting to the touch.  There is a fireplace in the north facing wall.  The fire within the hearth is buringing merrily, and you can feel its gentle warmth.  Above it, there is a lamp hanging on the wall. Looking around, there is a gate to the west, a hardwood door to the south, a white door to the east, and an open door to the north through which you can smell roasting root vegitables.

You can see a White Door, a Hardwood Door, a Gate, a lamp and a Fireplace (in which is a Fire) here.

>open envelope
You open Envelope, revealing Letter.

* * *

>i
You are carrying:
  Envelope
    Letter
  Key Ring
    a Silver key
    brass key
    a Metal key

>e
(first opening the White Door)

Toy Room
 .

On the Worktable is Mini Hammer.

You can also see a White Door here.

>hit key
Which do you mean, the Metal key or the Silver key?

>hit brass key with hammer
You can't see any such thing.

>rules on
Rules tracing now switched on. Type "rules off" to switch it off again, or "rules all" to include even rules which do not apply.

>hit brass key with mini hammer
You can't see any such thing.

>take hammer
[Rule "can't take yourself rule" applies.]
[Rule "can't take other people rule" applies.]
[Rule "can't take component parts rule" applies.]
[Rule "can't take people's possessions rule" applies.]
[Rule "can't take items out of play rule" applies.]
[Rule "can't take what you're inside rule" applies.]
[Rule "can't take what's already taken rule" applies.]
[Rule "can't take scenery rule" applies.]
[Rule "can only take things rule" applies.]
[Rule "can't take what's fixed in place rule" applies.]
[Rule "use player's holdall to avoid exceeding carrying capacity rule" applies.]
[Rule "can't exceed carrying capacity rule" applies.]
[Rule "standard taking rule" applies.]
[Rule "standard report taking rule" applies.]
Taken.

>hit key with hammer
Which do you mean, the Metal key or the Silver key?

>hit brass key with hammer
You can't see any such thing.

>i
[Rule "print empty inventory rule" applies.]
[Rule "print standard inventory rule" applies.]
You are carrying:
  Mini Hammer
  a Metal key
  brass key
  a Silver key

[Rule "report other people taking inventory rule" applies.]

>rules oof
I only understood you as far as wanting to rules.

>rules off
Rules tracing now switched off. Type "rules" to switch it on again.

* * *

>take lamp
Taken.

* * *

>e
(first opening the White Door)

Darkness
It is pitch dark, and you can't see a thing.

>take hammer
Taken.

>i
You are carrying:
  Mini Hammer
  a Metal key
  brass key
  a Silver key

>hit brass key with hammer
You hammer the key back into shape! Now it works. Yay.

* * *

>s
(first opening the Hardwood Door)
It seems to be locked.

>e
(first opening the White Door)

Toy Room
 .

On the Worktable is Mini Hammer.

You can also see a White Door here.

>take hammer
Taken.

>hit key with hammer
Which do you mean, the Metal key, brass key or the Silver key?

>hit brass key with hammer
You hammer the key back into shape! Now it works. Yay.

>w
Home Room
 .

You can see a White Door, a Hardwood Door and a Gate here.

>unlock hardwood door with brass key
You unlock the Hardwood Door.

>s
(first opening the Hardwood Door)

Santa's office
 .

You can see a Hardwood Door here.

>l
Santa's office
 .

You can see a Hardwood Door here.

>x santa transformer
You see nothing special about the Santa Transformer.

* * *

>n
Kitchen
 .

>x wall
 .

>l
Kitchen
 .