 Ah, it's so warm and cozy at home.  And today is Christmas Eve!  There will probably be tons of presents under the tree, and the food! The best food ever, roast beef, garlic mashed potatoes and gravy, how delicious.  Hey, what's up with this room?  This isn't my house, I don't have a fireplace, a lamp on the wall, or wooly carpet like this!  Ah, and why am I carrying a keyring and a letter?

ReplacementClause
An Interactive Fiction by Makana Tavepholjalern
Release 1 / Serial number 130316 / Inform 7 build 6G60 (I6/v6.32 lib 6/12N) SD

Home Room
 A beautifully old fashioned room with red brick walls.  The carpet is made of unbleached wool, and is soft and comforting to the touch.  There is a fireplace in the north facing wall.  The fire within the hearth is buringing merrily, and you can feel its gentle warmth.  Above it, there is a lamp hanging on the wall. Looking around, there is a gate to the west, a hardwood door to the south, a white door to the east, and an open door to the north through which you can smell roasting root vegitables.

You can see a White Door, a Hardwood Door, a Gate, a lamp and a Fireplace (in which is a Fire) here.

>open envelope
You open Envelope, revealing Letter.

* * *

>w
(first opening the Gate)
It seems to be locked.

>i
You are carrying:
  Envelope (closed)
  Key Ring
    a Silver key
    brass key
    a Metal key

>open gate with silver key
(first taking the Silver key)
You unlock the Gate.

>open gate
You open the Gate.

>w
Sleigh Room
 A room built for a sleigh, and a sleigh there is.  In the middle of the room is huge red Sleigh.  The wood is painted a dark crimpson color, and the edges are lined in gold.  The Sleigh is hooked up to 12 reindeer. To the north is an opening, kind of like a garage door.  You can see that there is a long drop from the entrance.  This house must be on the side of a mountain or something.  You'll need to fly out of here.

You can see a Gate, a door and santa's sleigh (empty) here.

>get in sleigh
You get into santa's sleigh.

>take coushin
That seems to be a part of santa's sleigh.

>take bench
That seems to be a part of santa's sleigh.

>take reindeer
That seems to be a part of santa's sleigh.

* * *

>light lamp
This dangerous act would achieve little.

* * *

>x window
You can't see any such thing.

* * *

>unlock gate with silver key
(first taking the Silver key)
You unlock the Gate.

>open gate
You open the Gate.

>n
Kitchen
 .

>s
Home Room
 A beautifully old fashioned room with red brick walls.  The carpet is made of unbleached wool, and is soft and comforting to the touch.  There is a fireplace in the north facing wall.  The fire within the hearth is buringing merrily, and you can feel its gentle warmth.  Above it, there is a lamp hanging on the wall. Looking around, there is a gate to the west, a hardwood door to the south, a white door to the east, and an open door to the north through which you can smell roasting root vegitables.

You can see a White Door, a Hardwood Door, a Gate, a lamp and a Fireplace (in which is a Fire) here.

>w
Sleigh Room
 A room built for a sleigh, and a sleigh there is.  In the middle of the room is huge red Sleigh.  The wood is painted a dark crimpson color, and the edges are lined in gold.  The Sleigh is hooked up to 12 reindeer. To the north is an opening, kind of like a garage door.  You can see that there is a long drop from the entrance.  This house must be on the side of a mountain or something.  You'll need to fly out of here.

You can see a Gate, a door and santa's sleigh (empty) here.

>n
You can't go that way.

>l
Sleigh Room
 A room built for a sleigh, and a sleigh there is.  In the middle of the room is huge red Sleigh.  The wood is painted a dark crimpson color, and the edges are lined in gold.  The Sleigh is hooked up to 12 reindeer. To the north is an opening, kind of like a garage door.  You can see that there is a long drop from the entrance.  This house must be on the side of a mountain or something.  You'll need to fly out of here.

You can see a Gate, a door and santa's sleigh (empty) here.

>get in sleigh
You get into santa's sleigh.

>fly sleigh
That's not a verb I recognise.

* * *

>i
You are carrying:
  Envelope (closed)
  Key Ring
    a Silver key
    brass key
    a Metal key

>x key ring
In Key Ring are a Silver key, brass key and a Metal key.

* * *

>take lamp
Taken.

>i
You are carrying:
  a lamp
  a Metal key
  brass key
  a Silver key

>light brass key with fire
 why would you want to light that?

>light lamp with key
Which do you mean, the Metal key, brass key or the Silver key?

>light lamp with metal key
You can't light anything with that.

* * *

>e
(first opening the White Door)
It seems to be locked.

>w
(first opening the Gate)
It seems to be locked.

>e
(first opening the White Door)
It seems to be locked.

* * *

>take lamp
Taken.

>turn on lamp
You switch the lamp on.

>e
(first opening the White Door)
It seems to be locked.

* * *

>light lamp
This dangerous act would achieve little.

>light lamp with fire
I only understood you as far as wanting to light the lamp.

I beg your pardon?

* * *

>light lamp with fire
I only understood you as far as wanting to light the lamp.

>light the lamp
This dangerous act would achieve little.

* * *

>e
(first opening the White Door)

Darkness
It is pitch dark, and you can't see a thing.

>s
You can't go that way.

>s
You can't go that way.

>x hardwood door
You can't see any such thing.

>w
Home Room
 A beautifully old fashioned room with red brick walls.  The carpet is made of unbleached wool, and is soft and comforting to the touch.  There is a fireplace in the north facing wall.  The fire within the hearth is buringing merrily, and you can feel its gentle warmth.  Above it, there is a lamp hanging on the wall. Looking around, there is a gate to the west, a hardwood door to the south, a metal door to the east, and an open door to the north through which you can smell roasting root vegitables.

You can see a White Door, a Hardwood Door, a Gate, a lamp and a Fireplace (in which is a Fire) here.

>s
(first opening the Hardwood Door)
It seems to be locked.

* * *

>s
 Are you going to walk through a hardwood door?  Who do you think you are?  You'll need to hammer that brass key flat again before you can unlock .

* * *

>n
Kitchen
 The heat of the hearth in the home room is felt even in the kitchen.  The walls are made of red brick, and there is a dinging table laden with food.  The east wall has some characters carved into the wall that you are unable to understand. 

You can see a front door and Dining table (on which are Roast Beef, Mashed potatoes, Roast Turkey, Smoked ham, Green beans and Bread Pudding) here.

>x wall
 You examine the curvy lines of the characters, but see nothing that you understand.  Upon closer inspection, you see that there is a line that marks out a rectangle that goes from the floor until your waist..

>l
Kitchen
 .

>x wall
You see nothing special about the wall.

* * *

>x wall
 You examine the curvy lines of the characters, but see nothing that you understand.  Upon closer inspection, you see that there is a line that marks out a rectangle that goes from the floor until your waist..

>open door
You must supply a noun.

>gonear elf
Darkness
It is pitch dark, and you can't see a thing.

>say hello
(to yourself)
There is no reply.

>hello
You must supply a noun.

>talk to elf
You can't see any such thing.

>say hello to elf
You can't see any such thing.

* * *

>n
Kitchen
 The heat of the hearth in the home room is felt even in the kitchen.  The walls are made of red brick, and there is a dinging table laden with food.  The east wall has some characters carved into the wall that you are unable to understand. 

You can see a front door and Dining table (on which are Roast Beef, Mashed potatoes, Roast Turkey, Smoked ham, Green beans and Bread Pudding) here.

>take mashed potatoes
Taken.

>s
Home Room
 A beautifully old fashioned room with red brick walls.  The carpet is made of unbleached wool, and is soft and comforting to the touch.  There is a fireplace in the north facing wall.  The fire within the hearth is buringing merrily, and you can feel its gentle warmth.  Above it, there is a lamp hanging on the wall. Looking around, there is a gate to the west, a hardwood door to the south, a white door to the east, and an open door to the north through which you can smell roasting root vegitables.

You can see a White Door, a Hardwood Door, a Gate, a lamp and a Fireplace (in which is a Fire) here.

>e
(first opening the White Door)
It seems to be locked.

>i
You are carrying:
  Mashed potatoes
  Envelope (closed)
  Key Ring
    a Silver key
    brass key
    a Metal key

>unlock white door with silver key
(first taking the Silver key)
That doesn't seem to fit the lock.

>unlock white door with metal key
(first taking the Metal key)
You unlock the White Door.

* * *

>e
(first opening the White Door)

Darkness
It is pitch dark, and you can't see a thing.

>take lamp
You can't see any such thing.

>w
Home Room
 A beautifully old fashioned room with red brick walls.  The carpet is made of unbleached wool, and is soft and comforting to the touch.  There is a fireplace in the north facing wall.  The fire within the hearth is buringing merrily, and you can feel its gentle warmth.  Above it, there is a lamp hanging on the wall. Looking around, there is a gate to the west, a hardwood door to the south, a white door to the east, and an open door to the north through which you can smell roasting root vegitables.

You can see a White Door, a Hardwood Door, a Gate, a lamp and a Fireplace (in which is a Fire) here.

>take lamp
Taken.

* * *

I beg your pardon?

>x fireplace
In the Fireplace is a Fire.

* * *

I beg your pardon?

>take fire
You're gonna carry that with your bare hands? Try looking around for something you can light instead.

>light lamp with fireplace
You can't light anything with that.

* * *

>open fireplace
That's not something you can open.

>light lamp
This dangerous act would achieve little.

>light lamp
This dangerous act would achieve little.

* * *

>light the lamp
This dangerous act would achieve little.

>x lamp
 Hanging from the wall is a lamp.  This one looks like a really old fashioned brass one.  There is a curvy brass handle at the top, and a container of oil with a wick sticking out.  The wick is surrounded by an oblong piece of hollow glass with an opening on the top for ventilation.  Pretty cool indeed.

>e
Darkness
It is pitch dark, and you can't see a thing.

>lit
That's not a verb I recognise.

>ligt
That's not a verb I recognise.

>light
What do you want to light?

>lamp
This dangerous act would achieve little.

>light fire
You can't see any such thing.

>light lamp
This dangerous act would achieve little.